1111111101011111110000000111
1010010101000000010000000101
1111111101000011111110000101
1000001011010000000111110101
1111011010110000000111010101
1111011011100000000001010111
0100001010000000001111010101
1111111011111110001000010101
1111111010000010001000010101
0000001111111110001000010111
0011100001000010001100010101
0010100111100111001100010101
0011100111100111001100011101
0001000111100111000100000001
00010000010000100001001111111
00011000010000000001000100001
00001100011111111111111111111
00000100010000100010000001
00111111110011111110000001
00100000000000001111111101
00100000000000000000001111
