1111100000011000111
1100001111110000010
1100011110001100010
1110011111111000010
0111111000011000010
0000110000011000111
0111110000011000111
0100000100011000110
0111111100011111110
000000111111
