111100000011110111110
001111001111000101011
000011111100000101101
000000110000000100101
000011111100000101101
001111001111000101001
111100000011110101101
000000000000011100101
111111111111000000001
000100100001111111111
111100100000000000000
